#######################################################################################
#                                                                                     #
#                                                                                     #
#                                                                                     #
#                                                                                     #
#                                                                                     #
#                                                                                     #
#                                                                                     #
#                                                                                     #
#                                                                                     #
#                                                                                     #
#                                                                                     #
#                                                                                     #
#                                                                                     #
#                                                                                     #
#                                                                                     #
#                                                                                     #
#                                                                                     #
#                                                                                     #
#                                                                                     #
#                                                                                     #
#                                                                                     #
#                                                                                     #
#                                                                                     #
#                                                                                     #
#                                                                                     #
#                                                                                     #
#                                                                                     #
#                                                                                     #
#                                                                                     #
#                                                                                     #
#                                                                                     #
#                                                                                     #
#                                                                                     #
#                                                                                     #
#                                                                                     #
#                                                                                     #
#######################################################################################